20 20
*vvvvvvvvvvvvvvvv*
>       C        <
>             #^^*
>             <   
>   C         #vv*
>                <
*^^#     C       <
   >           C <
*vv#             <
>                <
>      C      #^^*
>             <   
>             #vv*
>                <
*^^#             <
   >       C     <
*vv#             <
>           P    <
*^^^^^^^^^^^^^^^^*